10 10 10 10 10 10 10 10 10 10 10 10 10 10 10 10 10 10 10 10 10 10 10 10 10 10 10 10 10 10 10 10 10 10 10 10 10 10 10 10 10 10 10 10 10 10 10 10 10 10 10 10 10 10 10 10 10 10 10 10 10 10
10 10 10 10 10 10 10 10 10 10 10 10 10 10 10 10 10 10 10 10 10 10 10 10 10 10 10 10 10 10 10 10 10 10 10 10 10 10 10 10 10 10 10 10 10 10 10 10 10 10 10 10 10 10 10 10 10 10 10 10 10 10
10 10 10 10 10 10 10 10 10 10 10 10 10 10 10 10 10 10 10 10 10 10 10 10 10 10 10 10 10 10 10 10 10 10 10 10 10 10 10 10 10 10 10 10 10 10 10 10 10 10 10 10 10 10 10 10 10 10 10 10 10 10
10 10 10 10 10 10 10 10 10 10 10 10 10 10 10 10 10 10 10 10 10 10 10 10 10 10 10 10 10 10 10 10 10 10 10 10 10 10 10 10 10 10 10 10 10 10 10 10 10 10 10 10 10 10 10 10 10 10 10 10 10 10
10 10 10 10 10 10 10 10 10 10 10 10 10 10 10 10 10 10 10 10 10 10 10 10 10 10 10 10 10 10 10 10 10 10 10 10 10 10 10 10 10 10 10 10 10 10 10 10 10 10 10 10 10 10 10 10 10 10 10 10 10 10
10 10 10 10 10 10 10 10 10 10 10 10 10 10 10 10 10 10 10 10 10 10 10 10 10 10 10 10 10 10 10 10 10 10 10 10 10 10 10 10 10 10 10 10 10 10 10 10 10 10 10 10 10 10 10 10 10 10 10 10 10 10
10 10 10 10 10 10 10 10 10 10 10 10 10 10 10 10 10 10 10 10 10 10 10 10 10 10 10 10 10 10 10 10 10 10 10 10 10 10 10 10 10 10 10 10 10 10 10 10 10 10 10 10 10 10 10 10 10 10 10 10 10 10
10 10 10 10 10 10 10 10 10 20 18 18 18 18 18 18 18 18 18 18 18 18 18 18 18 21 10 10 10 10 10 10 10 20 18 18 18 18 18 18 18 18 18 18 18 18 18 18 18 18 18 18 21 10 10 10 10 10 10 10 10 10
10 10 10 10 10 10 10 10 10 16 24 24 24 24 24 24 24 27 27 27 27 27 27 27 24 43 43 43 43 43 43 43 43 43 24 27 27 27 27 27 27 27 27 27 27 27 27 27 27 27 27 27 17 21 10 10 10 10 10 10 10 10
10 10 10 10 10 10 10 10 10 16 24 25 25 25 25 25 24 27 27 27 27 27 27 27 24 15 10 10 10 10 10 10 10 16 24 27 27 27 27 27 27 27 27 27 27 27 27 27 27 27 27 27 27 17 21 10 10 10 10 10 10 10
10 10 10 10 10 10 10 10 10 16 24 25 30 30 30 25 24 27 27 27 27 27 27 27 24 15 10 10 10 10 10 10 10 16 24 27 27 27 27 27 27 27 27 27 27 27 27 27 27 27 27 27 27 27 15 10 10 10 10 10 10 10
10 10 10 10 10 10 10 10 10 16 24 25 30 30 30 25 24 27 27 27 27 27 27 27 24 17 21 10 10 10 10 10 20 19 24 27 27 27 27 27 27 24 24 24 24 24 24 24 24 27 27 27 27 27 15 10 10 10 10 10 10 10
10 10 10 10 10 10 10 10 10 16 24 25 30 30 30 25 24 27 27 27 27 27 27 27 24 24 17 18 43 43 43 18 19 24 24 27 27 27 27 27 24 24 24 24 24 24 24 24 24 24 27 27 27 27 15 10 10 10 10 10 10 10
10 10 10 10 10 10 10 10 10 16 24 25 25 30 25 25 24 27 27 27 27 27 27 27 27 24 24 24 35 29 34 24 24 24 27 27 27 27 27 27 24 24 24 24 24 24 24 24 24 24 27 27 27 27 15 10 10 10 10 10 10 10
10 10 10 10 10 10 10 10 10 16 24 24 24 24 24 24 24 27 27 27 27 27 27 27 27 27 27 24 35 29 34 24 27 27 27 27 27 27 27 27 27 24 24 24 24 24 24 24 24 27 27 27 27 27 15 10 10 10 10 10 10 10
10 10 10 10 10 10 10 10 10 16 24 24 24 24 24 24 24 27 27 27 27 27 27 27 27 27 27 27 35 29 34 27 27 27 27 27 27 27 27 27 27 27 24 24 24 24 24 24 27 27 27 27 27 27 15 10 10 10 10 10 10 10
10 10 10 10 10 10 10 10 10 16 27 24 24 24 24 24 27 27 27 27 27 27 27 27 27 27 27 27 35 29 34 27 27 27 27 27 27 27 27 27 27 27 27 27 24 24 27 27 27 27 27 27 27 27 15 10 10 10 10 10 10 10
10 10 10 10 10 10 10 10 10 16 27 27 24 24 24 27 27 27 27 27 27 27 27 27 27 27 27 27 35 29 34 27 27 27 27 27 27 27 27 27 27 27 27 27 24 24 27 27 27 27 27 27 27 27 15 10 10 10 10 10 10 10
10 10 10 10 10 10 10 10 10 16 27 27 27 24 27 27 27 27 27 27 27 27 27 27 27 27 27 27 35 29 34 27 27 27 27 27 27 27 27 27 27 27 27 27 24 24 27 27 27 27 27 27 27 27 15 10 10 10 10 10 10 10
10 10 10 10 10 10 10 10 10 16 27 27 27 24 27 27 27 27 27 27 27 27 27 27 27 27 27 27 35 29 34 27 27 27 27 27 27 27 27 27 27 27 27 27 24 24 27 27 27 27 27 27 27 27 15 10 10 10 10 10 10 10
10 10 10 10 10 10 10 10 10 16 27 27 27 24 24 27 27 27 27 27 27 27 27 27 27 27 27 27 35 29 34 27 27 27 27 27 27 27 27 27 27 27 27 27 24 24 27 27 27 27 27 27 27 27 15 10 10 10 10 10 10 10
10 10 10 10 10 10 10 10 10 16 27 27 27 27 24 27 27 27 27 27 27 27 27 27 27 27 27 27 35 29 34 27 27 27 27 27 27 27 27 27 27 27 27 27 24 24 27 27 27 27 27 27 27 27 15 10 10 10 10 10 10 10
10 10 10 10 10 10 10 10 10 16 27 27 27 27 24 27 27 27 27 27 27 27 27 27 27 27 27 24 35 29 34 24 27 27 27 27 27 27 27 27 27 27 27 27 24 24 27 27 27 27 27 27 27 27 15 10 10 10 10 10 10 10
10 10 10 10 10 10 10 10 10 16 27 27 27 25 24 25 27 27 27 27 27 27 27 27 27 27 24 24 35 29 34 24 24 27 27 27 27 27 27 27 27 27 27 24 24 24 27 27 27 27 27 27 27 27 15 10 10 10 10 10 10 10
10 10 10 10 10 10 10 10 10 16 27 27 27 25 24 25 27 27 27 27 27 27 27 27 27 24 24 28 35 29 34 28 24 24 27 27 27 27 27 27 27 27 24 24 24 24 27 27 27 27 27 27 27 27 15 10 10 10 10 10 10 10
10 10 10 10 10 10 10 10 10 16 27 27 27 25 24 25 27 27 27 27 27 27 27 27 24 24 28 39 38 29 36 40 28 24 24 27 27 27 27 27 27 24 24 24 24 24 27 27 27 27 27 27 27 27 15 10 10 10 10 10 10 10
10 10 10 10 10 10 10 10 10 16 27 27 27 27 24 39 37 37 37 37 37 37 37 37 37 37 37 38 29 29 29 36 37 37 37 37 37 37 37 37 37 37 40 24 24 27 27 27 27 27 27 27 27 27 15 10 10 10 10 10 10 10
10 10 10 10 10 10 10 10 10 16 27 27 27 27 24 35 29 29 29 29 29 29 29 29 29 29 29 29 29 29 29 29 29 29 29 29 29 29 29 29 29 29 34 24 24 27 27 27 27 27 27 27 27 27 15 10 10 10 10 10 10 10
10 10 10 10 10 10 10 10 10 16 27 27 27 27 24 41 32 32 32 32 32 32 32 32 32 32 32 33 29 29 29 31 32 32 32 32 32 32 32 32 32 32 42 24 24 27 27 27 27 27 27 27 27 27 15 10 10 10 10 10 10 10
10 10 10 10 10 10 10 10 10 16 27 27 27 27 24 27 27 27 27 27 27 27 27 27 24 24 28 41 33 29 31 42 28 24 24 27 27 27 27 27 27 24 24 24 24 27 27 27 27 27 27 27 27 27 15 10 10 10 10 10 10 10
10 10 10 10 10 10 10 10 10 16 27 27 27 27 24 27 27 27 27 27 27 27 27 27 27 24 24 28 35 29 34 28 24 24 27 27 27 27 27 27 27 27 24 24 24 27 27 27 27 27 27 27 27 27 15 10 10 10 10 10 10 10
10 10 10 10 10 10 10 10 10 16 27 27 27 27 24 27 27 27 27 27 27 27 27 27 27 27 24 24 35 29 34 24 24 27 27 27 27 27 27 27 27 27 24 24 24 27 27 27 27 27 27 27 27 27 15 10 10 10 10 10 10 10
10 10 10 10 10 10 10 10 10 16 27 27 27 25 24 25 27 27 27 27 27 27 27 27 27 27 27 24 35 29 34 24 27 27 27 27 27 27 27 27 27 27 24 24 24 27 27 27 27 27 27 27 27 27 15 10 10 10 10 10 10 10
10 10 10 10 10 10 10 10 10 16 27 27 27 25 24 25 27 27 27 27 27 27 27 27 27 27 27 27 35 29 34 27 27 27 27 27 27 27 27 27 27 27 24 24 24 27 27 27 27 27 27 27 27 27 15 10 10 10 10 10 10 10
10 10 10 10 10 10 10 20 18 19 27 27 27 25 24 25 27 27 27 27 27 27 27 27 27 27 27 27 35 29 34 27 27 27 27 27 27 27 27 27 27 27 24 24 24 27 27 27 27 27 27 27 27 27 15 10 10 10 10 10 10 10
10 10 10 10 10 10 10 16 27 27 27 27 27 27 24 27 27 27 27 27 27 27 27 27 27 27 27 27 35 29 34 27 27 27 27 27 27 27 27 27 27 27 24 24 24 27 27 27 27 27 27 27 27 27 15 10 10 10 10 10 10 10
10 10 10 10 10 10 10 16 27 27 27 27 27 27 24 27 27 27 27 27 27 27 27 27 27 27 27 27 35 29 34 27 27 27 27 27 27 27 27 27 27 24 24 24 24 24 27 27 27 27 27 27 27 27 15 10 10 10 10 10 10 10
10 10 10 10 10 10 10 16 27 27 27 27 27 24 24 27 27 27 27 27 27 27 27 27 27 27 27 27 35 29 34 27 27 27 27 27 27 27 27 27 27 24 24 24 24 24 27 27 27 27 27 27 27 27 15 10 10 10 10 10 10 10
10 10 10 10 10 10 10 16 27 27 27 24 24 24 24 27 27 27 27 27 27 27 27 27 27 27 27 27 35 29 34 27 27 27 27 27 27 27 27 27 27 24 24 27 24 24 27 27 27 27 27 27 27 27 15 10 10 10 10 10 10 10
10 10 10 10 10 10 10 16 24 24 24 24 24 24 27 27 27 27 27 27 27 27 27 27 27 27 27 27 35 29 34 27 27 27 27 27 27 27 27 27 27 24 24 24 24 24 27 27 27 27 27 27 27 27 15 10 10 10 10 10 10 10
10 10 10 10 10 10 10 16 24 24 24 24 24 24 27 27 27 27 27 27 27 27 27 27 27 27 27 27 41 32 42 27 27 27 27 27 27 27 27 27 27 24 24 24 28 24 27 27 27 27 27 27 27 27 15 10 10 10 10 10 10 10
10 10 10 10 10 10 10 16 24 24 24 24 24 27 27 27 27 27 27 27 27 27 27 27 27 27 27 24 24 24 24 24 24 27 27 27 27 27 27 27 27 24 28 24 24 24 27 27 27 27 27 27 27 27 15 10 10 10 10 10 10 10
10 10 10 10 10 10 10 16 24 24 24 24 27 27 27 27 27 27 27 27 27 27 27 27 27 27 24 24 24 24 24 24 24 24 24 27 27 27 27 27 27 24 24 24 24 24 27 27 27 27 27 27 27 27 15 10 10 10 10 10 10 10
10 10 10 10 10 10 10 16 24 24 24 24 27 27 27 27 27 27 27 27 27 27 27 27 27 24 24 24 24 24 24 24 24 24 24 27 27 27 27 27 27 24 24 24 24 24 27 27 27 27 27 27 24 24 15 10 10 10 10 10 10 10
10 10 10 10 10 10 10 16 24 24 24 24 27 27 27 27 27 27 27 27 27 27 27 27 24 24 24 24 24 24 27 24 24 24 24 24 24 24 24 24 24 24 24 24 24 27 27 27 27 27 27 27 24 24 15 10 10 10 10 10 10 10
10 10 10 10 10 10 10 22 13 44 13 13 13 13 13 13 14 24 24 24 24 24 24 24 24 24 24 24 24 24 24 24 24 24 24 24 24 24 24 24 24 24 24 28 27 27 27 27 27 27 27 27 24 24 15 10 10 10 10 10 10 10
10 10 10 10 10 10 10 10 10 44 10 10 10 10 10 10 22 14 24 24 24 24 24 24 24 24 24 24 24 27 27 27 27 27 27 27 27 27 24 24 24 24 28 28 27 27 27 27 27 27 27 27 24 24 15 10 10 10 10 10 10 10
10 10 10 10 10 10 10 10 10 44 10 10 10 10 10 10 10 22 14 24 24 24 24 24 24 24 24 27 27 27 27 27 27 27 27 27 27 27 28 28 24 24 24 27 27 27 27 27 27 27 27 24 24 24 15 10 10 10 10 10 10 10
10 10 10 10 20 18 18 18 18 44 18 18 18 21 10 10 10 10 16 24 24 24 24 24 24 24 27 27 27 27 27 27 27 27 27 27 27 28 28 28 27 24 24 24 24 27 27 27 27 27 24 24 24 24 15 10 10 10 10 10 10 10
10 10 10 10 16 27 27 27 24 24 24 27 24 17 21 10 10 10 16 24 24 24 24 24 24 27 27 27 27 27 27 27 27 27 27 27 27 28 28 28 28 24 24 24 24 24 24 24 24 24 24 24 24 27 15 10 10 10 10 10 10 10
10 10 10 10 16 27 27 27 24 24 24 24 24 24 17 21 10 10 16 24 24 24 24 24 27 27 27 27 27 27 27 27 27 27 27 27 27 27 27 27 27 27 24 24 24 24 24 24 24 24 24 24 27 27 15 10 10 10 10 10 10 10
10 10 10 10 16 27 27 27 24 24 24 24 24 27 24 15 10 10 16 24 24 24 24 24 27 27 27 27 27 27 27 27 27 27 27 27 27 27 28 27 27 27 27 27 27 27 27 27 27 27 27 27 27 27 15 10 10 10 10 10 10 10
10 10 10 10 16 27 27 27 27 24 24 24 24 24 24 43 43 43 43 24 24 24 24 24 27 27 27 27 27 27 27 27 27 24 24 24 27 27 27 27 27 27 27 27 27 27 27 27 27 27 27 27 27 27 15 10 10 10 10 10 10 10
10 10 10 10 16 27 27 27 24 24 24 24 24 24 24 15 10 10 16 24 24 24 24 24 24 24 24 24 24 24 24 24 24 24 24 24 27 27 27 27 27 27 27 27 27 27 27 27 27 27 27 27 27 27 15 10 10 10 10 10 10 10
10 10 10 10 16 27 27 27 24 27 24 24 27 24 24 15 10 10 22 13 13 13 13 13 13 13 13 13 13 13 13 13 13 13 13 13 13 13 13 13 13 13 13 13 13 13 13 13 13 13 13 13 13 13 23 10 10 10 10 10 10 10
10 10 10 10 16 27 27 27 24 24 24 24 24 24 24 15 10 10 10 10 10 10 10 10 10 10 10 10 10 10 10 10 10 10 10 10 10 10 10 10 10 10 10 10 10 10 10 10 10 10 10 10 10 10 10 10 10 10 10 10 10 10
10 10 10 10 16 27 27 27 27 27 27 27 27 27 27 15 10 10 10 10 10 10 10 10 10 10 10 10 10 10 10 10 10 10 10 10 10 10 10 10 10 10 10 10 10 10 10 10 10 10 10 10 10 10 10 10 10 10 10 10 10 10
10 10 10 10 22 13 13 13 13 13 13 13 13 13 13 23 10 10 10 10 10 10 10 10 10 10 10 10 10 10 10 10 10 10 10 10 10 10 10 10 10 10 10 10 10 10 10 10 10 10 10 10 10 10 10 10 10 10 10 10 10 10
10 10 10 10 10 10 10 10 10 10 10 10 10 10 10 10 10 10 10 10 10 10 10 10 10 10 10 10 10 10 10 10 10 10 10 10 10 10 10 10 10 10 10 10 10 10 10 10 10 10 10 10 10 10 10 10 10 10 10 10 10 10
10 10 10 10 10 10 10 10 10 10 10 10 10 10 10 10 10 10 10 10 10 10 10 10 10 10 10 10 10 10 10 10 10 10 10 10 10 10 10 10 10 10 10 10 10 10 10 10 10 10 10 10 10 10 10 10 10 10 10 10 10 10
10 10 10 10 10 10 10 10 10 10 10 10 10 10 10 10 10 10 10 10 10 10 10 10 10 10 10 10 10 10 10 10 10 10 10 10 10 10 10 10 10 10 10 10 10 10 10 10 10 10 10 10 10 10 10 10 10 10 10 10 10 10
10 10 10 10 10 10 10 10 10 10 10 10 10 10 10 10 10 10 10 10 10 10 10 10 10 10 10 10 10 10 10 10 10 10 10 10 10 10 10 10 10 10 10 10 10 10 10 10 10 10 10 10 10 10 10 10 10 10 10 10 10 10