1 1 1 1 1 1 1 1 1 1 1 1 1 1 1 1 1 1 1 1 1 1 1 1 1 1 1 1 1 1 1 1 1 1 1 1 1 1 1 1 1 1 1 1 1 1 1 1 1 1 1 1 1 1 1 1 1 1 1 1 1 1 
1 1 1 1 1 1 1 1 1 1 1 1 1 1 1 1 1 1 1 1 1 1 1 1 1 1 1 1 1 1 1 1 1 1 1 1 1 1 1 1 1 1 1 1 1 1 1 1 1 1 1 1 1 1 1 1 1 1 1 1 1 1 
1 1 1 1 1 1 1 1 1 1 1 1 1 1 1 1 1 1 1 1 1 1 1 1 1 1 1 1 1 1 1 1 1 1 1 1 1 1 1 1 1 1 1 1 1 1 1 1 1 1 1 1 1 1 1 1 1 1 1 1 1 1 
1 1 1 1 1 1 1 1 1 1 1 1 1 1 1 1 1 1 1 1 1 1 1 1 1 1 1 1 1 1 1 1 1 1 1 1 1 1 1 1 1 1 1 1 1 1 1 1 1 1 1 1 1 1 1 1 1 1 1 1 1 1 
1 1 1 1 1 1 1 1 1 1 1 1 1 1 1 1 1 1 1 1 1 1 1 1 1 1 1 1 1 1 1 1 1 1 1 1 1 1 1 1 1 1 1 1 1 1 1 1 1 1 1 1 1 1 1 1 1 1 1 1 1 1 
1 1 1 1 1 10 8 8 8 8 8 8 8 8 8 8 8 8 8 8 8 8 8 8 11 1 1 1 1 1 1 1 1 1 1 1 1 10 8 8 8 8 8 8 8 8 8 8 8 8 8 8 8 11 1 1 1 1 1 1 1 1 
1 1 1 1 1 6 31 31 31 31 31 31 31 1 1 1 1 1 1 1 1 1 1 1 7 11 1 1 1 1 1 1 1 1 1 1 10 9 1 1 1 1 1 1 1 1 1 1 1 1 1 1 1 7 11 1 1 1 1 1 1 1 
1 1 1 1 1 6 31 34 34 34 34 34 31 1 1 1 1 1 1 1 1 1 1 1 1 7 11 1 1 1 1 1 1 1 1 10 9 1 1 1 1 1 1 1 1 1 1 1 1 1 1 1 1 1 5 1 1 1 1 1 1 1 
1 1 1 1 1 6 31 34 30 30 30 34 31 1 1 1 1 1 1 1 1 1 1 1 1 1 7 11 1 1 1 1 1 1 10 9 1 1 1 1 1 1 1 1 1 1 1 1 1 1 1 1 1 1 7 11 1 1 1 1 1 1 
1 1 1 1 1 6 31 34 30 30 30 34 31 1 1 1 1 1 1 1 1 1 1 1 1 1 1 7 11 1 1 1 1 10 9 1 1 1 1 1 1 1 1 1 1 1 1 1 1 1 1 1 1 1 1 7 11 1 1 1 1 1 
1 1 1 1 1 6 31 34 30 30 30 34 31 1 1 1 1 1 1 1 1 1 1 1 1 1 1 1 7 8 28 28 8 9 1 1 1 1 1 1 1 1 1 31 31 31 31 31 31 31 1 1 1 1 1 1 5 1 1 1 1 1 
1 1 1 1 1 6 31 34 34 30 34 34 31 1 1 1 1 1 1 1 1 1 1 1 1 1 1 1 1 31 31 31 31 1 1 1 1 1 1 1 1 1 31 31 31 31 31 31 31 31 31 1 1 1 1 1 5 1 1 1 1 1 
1 1 1 1 1 6 31 31 31 31 31 31 31 1 1 1 1 1 1 1 1 1 1 1 1 1 1 1 1 1 31 31 1 1 1 1 1 1 1 1 1 1 31 31 1 31 31 31 31 31 31 1 1 1 1 1 5 1 1 1 1 1 
1 1 1 1 1 6 31 31 31 31 31 31 31 1 1 1 1 1 1 1 1 1 1 1 1 1 1 1 1 1 31 31 1 1 1 1 1 1 1 1 1 1 31 31 31 31 31 31 31 31 1 1 1 1 1 1 5 1 1 1 1 1 
1 1 1 1 1 6 1 31 31 31 31 31 1 1 1 1 1 1 1 1 1 1 1 1 1 1 1 1 1 1 31 31 1 1 1 1 1 1 1 1 1 1 1 31 31 31 31 31 31 1 1 1 1 1 1 1 5 1 1 1 1 1 
1 1 1 1 1 6 1 1 31 31 31 1 1 1 1 1 1 1 1 1 1 1 1 1 1 1 1 1 1 1 31 31 1 1 1 1 1 1 1 1 1 1 1 1 1 31 31 31 31 1 1 1 1 1 1 1 5 1 1 1 1 1 
1 1 1 1 1 6 1 1 1 31 1 1 1 1 1 1 1 1 1 1 1 1 1 1 1 1 1 1 1 1 31 31 1 1 1 1 1 1 1 1 1 1 1 1 1 1 31 31 31 31 1 1 1 1 1 1 5 1 1 1 1 1 
1 1 1 1 1 6 1 1 1 31 31 1 1 1 1 1 1 1 1 1 1 1 1 1 1 1 1 1 1 1 31 31 1 1 1 1 1 1 1 1 1 1 1 1 1 1 1 1 31 31 31 1 1 1 1 1 5 1 1 1 1 1 
1 1 1 1 1 6 1 1 1 1 31 1 1 1 1 1 1 1 1 1 1 1 1 1 1 1 1 1 1 1 31 31 1 1 1 1 1 1 1 1 1 1 1 1 1 1 1 1 31 31 31 1 1 1 1 1 5 1 1 1 1 1 
1 1 1 1 1 6 1 1 1 1 31 1 1 1 1 1 1 1 1 1 1 1 1 1 1 1 1 1 1 23 21 21 24 1 1 1 1 1 1 1 1 1 1 1 1 1 1 1 31 31 31 31 1 1 1 1 5 1 1 1 1 1 
1 1 1 1 1 6 1 1 1 1 31 1 1 1 1 1 1 1 1 1 1 1 1 1 1 1 1 1 31 19 14 14 18 31 1 1 1 1 1 1 1 1 1 1 1 1 1 1 1 31 31 31 1 1 1 1 5 1 1 1 1 1 
1 1 1 1 1 6 1 1 1 1 31 1 1 1 1 1 1 1 1 1 1 1 1 1 1 1 1 31 31 19 14 14 18 31 31 1 1 1 1 1 1 1 1 1 1 1 1 1 1 31 31 31 1 1 1 1 5 1 1 1 1 1 
1 1 1 1 1 6 1 1 1 31 31 1 1 1 1 1 1 1 1 1 1 1 1 1 1 1 31 31 31 19 14 14 18 31 31 31 1 1 1 1 1 1 1 1 1 1 1 1 1 1 31 31 1 1 1 1 5 1 1 1 1 1 
1 1 1 1 1 6 1 1 31 31 1 1 1 1 1 1 1 1 1 1 1 1 1 1 1 31 31 31 31 19 14 14 18 31 31 31 31 1 1 1 1 1 1 1 1 1 1 1 1 1 31 31 1 1 1 1 5 1 1 1 1 1 
1 1 1 1 1 6 1 1 31 1 1 1 1 1 1 1 1 1 1 1 1 1 1 1 31 31 31 31 31 19 14 14 18 31 31 31 31 31 1 1 1 1 1 1 1 1 1 1 1 1 31 31 1 1 1 1 5 1 1 1 1 1 
1 1 1 1 1 6 1 1 31 1 1 1 1 1 1 1 1 1 1 1 1 1 1 31 31 31 31 31 31 19 14 14 18 31 31 31 31 31 31 1 1 1 1 1 1 1 1 1 1 1 31 31 1 1 1 1 5 1 1 1 1 1 
1 1 1 1 1 6 1 1 31 1 1 1 1 1 1 1 1 1 1 1 1 1 31 31 31 31 31 31 33 19 14 14 18 33 31 31 31 31 31 31 1 1 1 1 1 1 1 1 1 1 31 31 1 1 1 1 5 1 1 1 1 1 
1 1 1 1 1 6 1 34 31 34 1 1 1 1 1 1 1 1 1 1 1 31 31 31 31 31 31 31 31 19 14 14 18 31 31 31 31 31 31 31 31 1 1 1 1 1 1 1 1 31 31 31 1 1 1 1 5 1 1 1 1 1 
1 1 1 1 1 6 1 34 31 34 1 1 1 1 1 1 1 1 1 1 31 31 31 31 31 31 33 31 31 19 14 14 18 31 31 33 31 31 31 31 31 31 1 1 1 1 1 1 31 31 31 31 1 1 1 1 5 1 1 1 1 1 
1 1 1 1 1 6 1 34 31 34 1 1 1 1 1 1 1 1 1 23 21 21 21 21 21 21 21 21 21 22 14 14 20 21 21 21 21 21 21 21 21 21 24 1 1 1 1 31 31 31 31 1 1 1 1 1 5 1 1 1 1 1 
1 1 1 1 1 6 1 1 31 31 31 31 31 31 31 31 31 31 31 19 14 14 14 14 14 14 14 14 14 14 14 14 14 14 14 14 14 14 14 14 14 14 18 31 31 31 31 31 31 31 1 1 1 1 1 1 5 1 1 1 1 1 
1 1 1 1 1 6 1 1 31 31 31 31 31 31 31 31 31 31 31 19 14 14 14 14 14 14 14 14 14 14 14 14 14 14 14 14 14 14 14 14 14 14 18 31 31 31 31 31 1 1 1 1 1 1 1 1 5 1 1 1 1 1 
1 1 1 1 1 6 1 34 31 34 1 1 1 1 1 1 1 1 1 25 16 16 16 16 16 16 16 16 16 17 14 14 15 16 16 16 16 16 16 16 16 16 26 1 1 1 1 31 1 1 1 1 1 1 1 1 5 1 1 1 1 1 
1 1 1 1 1 6 1 34 31 34 1 1 1 1 1 1 1 1 1 1 31 31 31 31 31 31 33 31 31 19 14 14 18 31 31 33 31 31 31 31 31 31 1 1 1 1 1 31 31 1 1 1 1 1 1 1 5 1 1 1 1 1 
1 1 1 1 1 6 1 34 31 34 1 1 1 1 1 1 1 1 1 1 1 31 31 31 31 31 31 31 31 19 14 14 18 31 31 31 31 31 31 31 31 1 1 1 1 1 1 31 31 1 1 1 1 1 1 1 5 1 1 1 1 1 
1 1 1 1 1 6 1 1 31 1 1 1 1 1 1 1 1 1 1 1 1 1 31 31 31 31 31 31 33 19 14 14 18 33 31 31 31 31 31 31 1 1 1 1 1 1 1 31 1 31 1 1 1 1 1 1 5 1 1 1 1 1 
1 1 1 1 1 6 1 1 31 1 1 1 1 1 1 1 1 1 1 1 1 1 1 31 31 31 31 31 31 19 14 14 18 31 31 31 31 31 31 1 1 1 1 1 1 1 1 31 31 31 31 1 1 1 1 1 5 1 1 1 1 1 
1 1 1 1 1 6 1 1 31 1 1 1 1 1 1 1 1 1 1 1 1 1 1 1 31 31 31 31 31 19 14 14 18 31 31 31 31 31 1 1 1 1 1 1 1 1 1 31 31 31 31 1 1 1 1 1 5 1 1 1 1 1 
1 1 1 1 1 6 1 31 31 31 1 1 1 1 1 1 1 1 1 1 1 1 1 1 1 31 31 31 31 19 14 14 18 31 31 31 31 1 1 1 1 1 1 1 1 1 1 1 31 31 31 1 1 1 1 1 5 1 1 1 1 1 
1 1 1 1 1 6 1 31 31 31 1 1 1 1 1 1 1 1 1 1 1 1 1 1 1 1 31 31 31 19 14 14 18 31 31 31 1 1 1 1 1 1 1 1 1 1 1 1 1 31 1 1 1 1 1 1 5 1 1 1 1 1 
1 1 1 1 1 6 1 1 1 31 1 1 1 1 1 1 1 1 1 1 1 1 1 1 1 1 1 31 31 19 14 14 18 31 31 1 1 1 1 1 1 1 1 1 1 1 1 1 1 31 1 1 1 1 1 1 5 1 1 1 1 1 
1 1 1 1 1 6 1 1 1 31 31 1 1 1 1 1 1 1 1 1 1 1 1 1 1 1 1 1 31 19 14 14 18 31 1 1 1 1 1 1 1 1 1 1 1 1 1 1 1 31 31 31 1 1 1 1 5 1 1 1 1 1 
1 1 1 1 1 6 1 1 1 1 31 1 1 1 1 1 1 1 1 1 1 1 1 1 1 1 1 1 1 25 16 16 26 1 1 1 1 1 1 1 1 1 1 1 1 1 1 1 1 31 31 31 1 1 1 1 5 1 1 1 1 1 
1 1 1 1 1 12 3 3 3 3 28 3 3 3 3 3 4 1 1 1 1 1 1 1 1 1 1 1 1 1 31 31 1 1 1 1 1 1 1 1 1 1 1 1 1 1 1 1 1 31 1 1 1 1 1 1 5 1 1 1 1 1 
1 1 1 1 1 1 1 1 1 1 28 1 1 1 1 1 12 4 1 1 1 1 1 1 1 1 1 1 1 1 31 31 1 1 1 1 1 1 1 1 1 1 1 1 1 1 1 31 31 31 31 1 1 1 1 1 5 1 1 1 1 1 
1 1 1 1 1 10 8 8 8 8 28 8 8 8 8 8 11 12 4 1 1 1 1 1 1 1 1 1 1 1 31 31 1 1 1 1 1 1 1 1 1 1 1 1 1 1 1 31 31 31 31 31 1 1 1 1 5 1 1 1 1 1 
1 1 1 1 1 6 1 1 1 31 31 31 31 31 1 1 7 11 12 4 1 1 1 1 1 1 1 1 1 1 31 31 1 1 1 1 1 1 1 1 1 1 1 1 1 1 1 31 31 31 31 31 31 1 1 1 5 1 1 1 1 1 
1 1 1 1 1 6 1 1 1 31 31 31 31 31 1 1 1 7 11 12 4 1 1 1 1 1 1 1 1 1 31 31 1 1 1 1 1 1 1 1 1 1 1 1 1 1 31 31 31 31 31 31 1 1 1 1 5 1 1 1 1 1 
1 1 1 1 1 6 1 1 1 31 31 31 31 1 31 1 1 1 5 1 6 1 1 1 1 1 1 1 1 1 31 31 1 1 1 1 1 1 1 1 1 1 1 1 1 1 31 31 1 31 31 31 1 1 1 1 5 1 1 1 1 1 
1 1 1 1 1 6 1 1 1 31 31 31 31 31 31 31 1 1 5 1 6 1 1 31 1 1 1 1 31 1 31 31 1 1 1 1 1 1 1 1 1 1 1 1 1 31 31 31 31 31 31 31 1 1 1 1 5 1 1 1 1 1 
1 1 1 1 1 6 1 1 1 1 31 31 31 31 31 31 31 31 27 27 27 31 31 31 31 1 1 31 31 1 31 31 1 1 1 31 31 31 31 31 1 31 31 1 1 31 31 31 31 31 31 31 1 1 1 1 5 1 1 1 1 1 
1 1 1 1 1 6 1 1 1 1 1 31 31 31 31 31 31 1 5 1 6 1 31 31 31 31 31 31 31 31 31 31 31 31 1 31 31 31 1 31 31 31 31 31 31 31 31 31 31 1 31 31 1 1 1 1 5 1 1 1 1 1 
1 1 1 1 1 6 1 1 1 31 31 31 31 31 1 1 1 1 5 1 6 1 1 1 1 31 31 1 31 31 31 31 31 31 31 31 31 1 31 31 31 31 31 31 31 31 31 31 31 31 31 31 1 1 1 1 5 1 1 1 1 1 
1 1 1 1 1 12 4 1 1 1 1 1 1 1 1 1 1 1 5 1 6 1 1 1 1 1 1 1 31 31 1 31 31 31 31 31 31 1 1 1 1 1 1 31 31 31 1 31 31 31 31 1 1 1 1 1 5 1 1 1 1 1 
1 1 1 1 1 1 6 1 1 1 1 1 1 1 1 1 1 1 5 1 6 1 1 1 1 1 1 1 1 1 1 1 1 1 1 1 1 1 1 1 1 1 1 1 1 1 1 1 1 1 1 1 1 1 1 1 5 1 1 1 1 1 
1 1 1 1 1 1 12 4 1 1 1 1 1 1 1 1 1 1 5 1 6 1 1 1 1 1 1 1 1 1 1 1 1 1 1 1 1 1 1 1 1 1 1 1 1 1 1 1 1 1 1 1 1 1 1 1 5 1 1 1 1 1 
1 1 1 1 1 1 1 12 3 3 3 3 3 3 3 3 3 3 13 1 12 3 3 3 3 3 3 3 3 3 3 3 3 3 3 3 3 3 3 3 3 3 3 3 3 3 3 3 3 3 3 3 3 3 3 3 13 1 1 1 1 1 
1 1 1 1 1 1 1 1 1 1 1 1 1 1 1 1 1 1 1 1 1 1 1 1 1 1 1 1 1 1 1 1 1 1 1 1 1 1 1 1 1 1 1 1 1 1 1 1 1 1 1 1 1 1 1 1 1 1 1 1 1 1 
1 1 1 1 1 1 1 1 1 1 1 1 1 1 1 1 1 1 1 1 1 1 1 1 1 1 1 1 1 1 1 1 1 1 1 1 1 1 1 1 1 1 1 1 1 1 1 1 1 1 1 1 1 1 1 1 1 1 1 1 1 1 
1 1 1 1 1 1 1 1 1 1 1 1 1 1 1 1 1 1 1 1 1 1 1 1 1 1 1 1 1 1 1 1 1 1 1 1 1 1 1 1 1 1 1 1 1 1 1 1 1 1 1 1 1 1 1 1 1 1 1 1 1 1 
1 1 1 1 1 1 1 1 1 1 1 1 1 1 1 1 1 1 1 1 1 1 1 1 1 1 1 1 1 1 1 1 1 1 1 1 1 1 1 1 1 1 1 1 1 1 1 1 1 1 1 1 1 1 1 1 1 1 1 1 1 1 
1 1 1 1 1 1 1 1 1 1 1 1 1 1 1 1 1 1 1 1 1 1 1 1 1 1 1 1 1 1 1 1 1 1 1 1 1 1 1 1 1 1 1 1 1 1 1 1 1 1 1 1 1 1 1 1 1 1 1 1 1 1 
